........................
.......W....W...........
***.....................
......***..***..........
1..................X..W.
************************
........................
........................
*****..........*********
........................
........................
******........**********
........................
........................
...****......****.......
Watch out, the ice is slippery!