........................................................................................................................
.....................................................................................................................X..
....................................................................................................####################
........................................................................................................................
........................................................................................................................
................................................................................####################....................
.....................................................................................................#..................
....................................................................................................#...................
............................................................####################...................#....................
..................................................................................................#.....................
.................................................................................................#......................
........................................####################....................................#.......................
...............................................................................................#........................
..............................................................................................#.........................
....................####################.....................................................#..........................
............................................................................................#...........................
.1.........................................................................................#............................
###########################################################################################.............................
This is a test level.
